11111111111111111111111111111111111111111111111111111
11111111111111111111111111111111111111111111111111111
11111111111111000000000000000011111111111111111111111
1111111111111100000000CCCC000011111111111111111111111
11111111111111000000000000000011111111111111111111111
11111111111111000P0000CCCCC00000000000000111111111111
1111111111111100000000000E000011111111111111111111111
111111111111100000CCCCCCCCC00000000000000111111111111
11111111111111111111111111111111111111111111111111111
