1111111111
101E010C11
1C0C0P00C1
1111111111
