1111111
1110001
1PC0E01
1111111
