1111111111
101E011C11
1C0000P0C1
1000000111
1000011111
1111110111
1111111111
