1111111111
1010011C11
1C0000P0C1
100E000111
1000011111
1111110111
1111111111
