1111111111
1011E10C11
1CCCP0E0C1
1111111111
